10
1150 2433 Type1
2018 2272 Type1
1919 1500 Type1
1727 544 Type1
1890 415 Type1
2145 482 Type1
227 1636 Type1
132 930 Type1
701 444 Type1
1025 444 Type1
0